###############
#@00000C000C0%#
#0C00C0000C00##
###C0%000C000C#
#000000C00C0%0#
##0#0C00000#C0#
#00C000C000C00#
#000C00000C0###
#0C0%0000000C0#
#0###00C00000C#
#C0000C#00&C00#
##0C000%0C#000#
#0C00X00C000C##
##0000%000C000#
###############