#########################
#@0000000C0000#000000C0%#
#####000000000#000000000#
#0000000000000#000000####
#0000000000C00####000000#
#000000000000000000C0000#
#00000000000000000000000#
#0C000000#####0000C00000#
#00000000000000000000000#
#00000C00000000000000000#
########000000000000C000#
#00000%#0000000000000000#
#000000#0000000000000000#
#0000000C00000######0C00#
#0000000000000#&#0000000#
#00000000000000000000000#
#000000C00000C00000%0000#
#00000000000000000#######
#00000000000000000000000#
#000%0##0000000000000000#
#00000X00#0000C000000000#
#00000000#00000000000000#
#00000000#0000000000C000#
#00000000#00000C00000000#
#########################