####################
#@000###0C000000000#
#0000C00000C000#000#
#0%00000000####000C#
#000000C00000000000#
#000%00000000000000#
#00C0000000000C0000#
#000000000000000000#
#00C00000000%000000#
#000000C00000000#0&#
#000000000000000####
#0000000000C0000000#
####000000000000000#
#0C000000000C000000#
#00X000000000000000#
#0000000C0000000000#
#0000000#00000C0000#
#0000000#0000000000#
#0C00000#0000000C00#
#################### 