###############
#@00C0%0C00C00#
####C00C00000C#
#C0####C0%0C0C#
#00000000C00###
#C00C000C0%0C0#
#00%0C000C000C#
#000###C0&0000#
#0C000%0C000C0#
###0C00C000####
#00C00##0000C0#
#C0%C000000#0C#
#0C00000C000C##
####0X00000C0C#
###############