#########################
#@0#0000000000000000C000#
#00#000C000000%000000000#
#00000000000000000000####
#0000000000C000000000000#
#00000C000000000000C0000#
#00000000000000000000000#
#0C0########000000C00000#
#00000000000000000000000#
#00000C00000000000000000#
#0000000000000000C000000#
#0000%000000#0000########
#00000000000#00000000000#
#0000000C000#00000000C00#
#00000000000#00000000000#
#00000000000#00000000000#
#000000C0000#0C00000%000#
#00000000000#00000000000#
#00000000000#00000000000#
#000#0000000000000000000#
#00&#0000000000C00000000#
#####0000000000000000000#
#00%00000C0000000000X000#
#00000000000000000000000#
#########################