###############
#@      C  C %#
# C  C     C###
###C %   C   C#
#      C  C % #
## # C     #C #
#  C   C   C  #
#   C     C ###
# C %       C #
# ###  C     C#
#C    C#  &C  #
## C   % C#   #
# C  X  C   C##
##    %   C   #
###############