####################
#@000###0C000000%C0#
#0C00C00000C0000#00#
#0000000000####000C#
#00000C000000000000#
#000%00000000000000#
#000000C000000C0000#
#000000000000000000#
#00C00000000%000000#
########00000000000#
#000000#C0000000000#
#000&00#0000C000000#
#000000#00000000000#
#0C0000#00000C00000#
#000000#00000000000#
#000%000C0000000####
#0000000000000000C0#
#####00000X00000000#
#0C000000000000000%#
#################### 